11111111
1P00EC01
10000001
11111111