11111111
1P00E0C1
1000C001
11111111