11111111
1000E001
10P00001
1000C001
11111111