11111111111111111111
10010000000000000001
101E100000000P000001
1000000000O000000001
10000C00000000000001
10000000000000000001
11111111111111111111