111111111111111
1P0000000100001
111101110101111
1C00010100000E1
101110100011101
1000101010000C1
101110101011101
1C00000010000C1
111111111111111
