11111111111111111111111111111111111111111111111111111111
10CC0000000000000000000000000000000000000000000000000001
10P00000000000000000000000000000000000000000000000000001
10000000000000000000000000000000000000000000000000000001
100000C0000C0000000000E000000000000000000000000000000001
10000000000000000000000000000000000000000000000000000001
10000000000000000000000000000000000000000000000000000001
10000000000000000000000000000000000000000000000000000001
10000000000000000000000000000000000000000000000000000001
10000000000000000000000000000000000000000000000000000001
10000000000000000000000000000000000000000000000000000001
11111111111111111111111111111111111111111111111111111111