111111111111111
100000000000001
10P000000000001
100000000000001
100000000000E01
111111111111111