1111111111111111111111111111111111
1PO0000000000000000000000000000001
10OOOOO000000000000OOOOO0000000001
1C0C0CO00000000000OC0C0CO000000001
1OOOO0O00000000000O0OOO0O0OOOOOO01
1000OCO00000000000OCO0OCO0OC0C0CO1
1000O0OOOOOOOOOOOOO0O0O0OOO0OOO0O1
1000OC0C0C0C0C0C0C0CO0OC0C0CO0OCO1
1000OOOOOOOOOOOOOOOOO0OOOOOOO0O0E1
1111111111111111111111111111111111